9
7
3 1 6 2 1 4 3
2 5 1 1 1 1 0
3 1 3 7 1 1 3
1 1 8 2 1 1 1
2 3 1 1 4 3 1
1 1 1 6 1 1 2
2 1 3 1 1 1 1
1 2 3 1 5 2 4
1 1 1 1 1 3 1