10
10
1 2 3 1 1 5 1 3 6 1
2 1 3 1 7 1 1 3 1 4
1 1 1 1 3 1 3 1 8 1
3 6 1 1 1 1 2 1 4 1
1 1 1 1 2 7 1 1 1 1
4 3 2 1 1 1 1 3 2 0
3 1 1 6 1 3 1 1 1 1
2 1 3 1 5 2 1 1 3 1
1 3 1 2 1 1 8 1 4 1
3 1 7 1 1 1 1 3 1 1