8
8
3 2 6 1 4 3 1 1
2 1 1 5 3 1 1 0
3 7 2 1 1 2 1 1
1 1 1 4 1 3 1 1
3 1 8 3 1 6 1 1
2 3 1 1 1 1 1 1
3 1 2 7 1 2 1 1
1 1 1 1 2 1 4 3